111111111111111111111111111111111111111111111111111111111111111111111111111
100000000000000000000000110000000000000000000000011000000000000000000000001
100000000000000000000000110000000000000000000000011000000000000000000000001
100000000000000000000000110000000000000000000000011000000000000000000000001
100000000000000000000000110000000000000000000000011000000000000000000000001
100000000000000000000000110000000000000000000000011000000000000000000000001
100000000000000000000000110000000000000000000000011000000000000000000000001
100000000000000000000000110000000000000000000000011000000000000000000000001
100000000000000000000000110000000000000000000000011000000000000000000000001
100000000000000000000000110000000000000000000000011000000000000000000000001
100000000000000000000000110000000000000000000000011000000000000000000000001
100000000000000000000000110000000000000000000000011000000000000000000000001
100000000000000000000000110000000000000000000000011000000000000000000000001
100000000000000000000000110000000000000000000000011000000000000000000000001
100000000000000000000000110000000000000000000000011000000000000000000000001
100000000000000000000000110000000000000000000000011000000000000000000000001
111111111111111111111111111111111111111111111111111111111111111111111111111
111111111111111111111111111111111111111111111111111111111111111111111111111
100000000000000000000000110000000000000000000000000000000000000000000000001
100000000000000000000000110000000000000000000000000000000000000000000000001
100000000000000000000000110000000000000000000000000000000000000000000000001
100000000000000000000000110000000000000000000000000000000000000000000000001
100000000000000000000000110000000000000000000000000000000000000000000000001
100000000000000000000000110000000000000000000000000000000000000000000000001
100000000000000000000000110000000000000000000000011000000000000000000000001
100000000000000000000000110000000000000000000000011000000000000000000000001
100000000000000000000000110000000000000000000000011000000000000000000000001
100000000000000000000000110000000000000000000000011000000000000000000000001
100000000000000000000000110000000000000000000000011000000000000000000000001
100000000000000000000000110000000000000000000000011000000000000000000000001
100000000000000000000000110000000000000000000000011000000000000000000000001
100000000000000000000000110000000000000000000000011000000000000000000000001
100000000000000000000000110000000000000000000000011000000000000000000000001
111111111111111111111111111111111111111111111111111111111111111111111110001
111111111111111111111111111111111111111111111111111111111111111111111000001
100000000000000000000000110000000000000000000000011000000000000000000000001
100000000000000000000000000000000000000000000000011000000000000000000000001
100000000000000000000000000000000000000000000000011000000000000000000000111
100000000000000000000000000000000000000000000000011000000000000000000000001
100000000000000000000000020000000000000000000000011000000000000000000000001
100000000000000000000000000000000000000000000000000000000000000000000100001
100000000000000000000000000000000000000000000000000000000000000000000000001
100000000000000000000000111000001100000000000000000000000000100001000000001
100000000000001100011000111000000000000000000000000000000000000000000000001
100000000000001100011000111000000000000000000000000000000000000000000000001
100000000110000000000000111000000000000011000001111000000100000000000000001
100000000110000000000000111110000000000000000000111000000000000000000000001
100000000000000000000000111110000000000000000000011110000000000000000000001
100001100000000000000000111110000000000000000000011110000000000000000000001
100001100000000000000000111110000000000000000000011110000000000000000000001
111111111111111111111111111111111111111111111111111111111111111111111111111