1111111111111111111111111111111111111111111111111111111111111111111111
1000000000000000000000000000000001100000000000000000000000000000000001
1000000000000000000000000000000000000000000000000000000000000000000001
1000000000000000000000000000000000000000000000000000000000000000000001
1000000000000000000000000000000000000000000000000000000000000000000001
1000000000000000000000000000000000000000000000000000000000000000000001
1000000000000000000000000000000000000000000000000000000000000000000001
1000000000000000000000000000000000000000000000000000000000000000000001
1000000000000000000000000000000000000000000000000000000000000000000001
1000000000000000000000000000000000000000000000000000001000001100000001
1000000000000000000000000000000000000000000001000000000000000000000001
1000000000000000000000000000000000000000000000000000000000000000000001
1000000000000000000000000000000000000000000000000000000000000000000001
1110000011000001100000000110000000000001000000000110000000000000000111
1000000000000000000000000000000000000001000000000000000000000000000111
1000000000000000000000000000000000000001000000000000000000000000000111
1000000000000000000011000000001111111111111000000000000000000000000111
1000000000000000000000000000000000000000000000000000000000000011000111
1000000000000000000000000000000000000000000000000000000000000011000111
1000000000000000000000000000000000000000000000000000000000000011000111
1000000000000001100000000110000000000000000000110000000000111111111111
1000000000000001100000000110000000000000000000110000000000111111111111
10p0000011000111100011000111100000000000000000110001100000111111111111
1000000011000111100011000111100000000000000000110001100000111111111111
1111111111111111111111111111111111111111111111111111111111111111111111