tttttttttttttttttttttttttttttttttttttttttttttttttttttttttttttttttttttt
t000000000000000000000000000000000tt000000000000000000000000000000000t
t000000000000000000000000000000000tt000000000000000000000000000000000t
t000000000000000000000000000000000tt000000000000000000000000000000000t
t000000000000000000000000000000000tt000000000000000000000000000000000t
t000000000000000000000000000000000tt000000000000000000000000000000000t
t000000000000000000000000000000000tt000000000000000000000000000000000t
t000000000000000000000000000000000tt000000000000000000000000000000000t
t000000000000000000000000000000000tt000000000000000000000000000000000t
t000000000000000000000000000000000tt000000000000000000t00000tt0000000t
t000000000000000000000000000000000tt000000000t00000000000000000000000t
t00000000000000000000000000000000000000000000000000000000000000000000t
t00000000000000000000000000000000000000000000000000000000000000000000t
ttt00000tt00000tt00000000tt000000000000t000000000tt0000000000000000ttt
t00000000000000000000000000000000000000t000000000000000000000000000ttt
t00000000000000000000000000000000000000t000000000000000000000000000ttt
t0000000000000000000tt00000000ttttttttttttt000000000000000000000000ttt
t0000000000000000000000000000000000000000000000000000000000000tt000ttt
t0000000000000000000000000000000000000000000000000000000000000tt000ttt
t0000000000000000000000000000000000000000000000000000000000000tt000ttt
t00000000000000tt00000000tt0000000000000000000tt0000000000tttttttttttt
t00000000000000tt00000000tt0000000000000000000tt0000000000tttttttttttt
t0000000tt000tttt000tt000tttt0000000p000000000tt000tt00000tttttttttttt
t0000000tt000tttt000tt000tttt00000000000000000tt000tt00000tttttttttttt
tttttttttttttttttttttttttttttttttttttttttttttttttttttttttttttttttttttt