11111111111111111111111111111111111111111111111111
10000000000000000000000011000000000000000000000001
10000000000000000000000011000000000000000000000001
10000000000000000000000000000000000000000000000001
10000000000000000000000000000000000000000000000001
10000000000000000000000000000000000000000000000001
10000000000000000000000000000000000000000000000001
10000000000000000000111111111110000000000000000001
10000000000000000000000000000000000000000000000001
10000000000000000000000000000000000000000000000001
10000000000000000000000000000000000001100001100001
10000000000000000000000000000000000001100000000001
10000000011000000000000000000000000001100000000001
10000000011000000000000000000000000001100000000001
10200001111000011000000000000000011111111111111111
10000001111000011000000000000000011111111111111111
11111111111111111111111111111111111111111111111111