1111111111111111111111111111111111111111111111111111111111111111111111
1000000000000000000000000000000000110000000000000000000000000000000001
1000000000000000000000000000000000110000000000000000000000000000000001
1000000000000000000000000000000000110000000000000000000000000000000001
1000000000000000000000000000000000110000000000000000000000000000000001
1000000000000000000000000000000000110000000000000000000000000000000001
1000000000000000000000000000000000110000000000000000000000000000000001
1000000000000000000000000000000000110000000000000000000000000000000001
1000000000000000000000000000000000110000000000000000000000000000000001
1000000000000000000000000000000000113333300001100000011000003300000001
1000000000000000000000000000000000110000000000000000000000000000000001
1000000000000000000000000000000000110000000000000000000000000000000001
1333000011000001100000000110000000223333300000000000000000000000000001
1000000000000000000000000000000000000000000000000000000000003333333111
1000000000000000000000000000000000000000000000000000000000000000000111
1000000000000000000000000000000000000000000000000000000000000000000111
1333000000000000000333300000001111111113311330000000000000003333333111
1000000000000000000000000000000000000110011000000000000000000000000111
1000000000000000000000000000000000000110011000000000000000000000000111
1000000000000000000000000000000000000110011000000000000000111111111111
1333000000000001100000000110000000000223322000001100000000111111111111
1000000000000001100000000110000000000000000000001100000000111111111111
1000000011000111100011000111100000000000000000001100011000111111111111
1000000011000111100011000111100000000000000000001100011000111111111111
1111111111111111133311333111111111111111111111111133311333111111111111
1111111222222222200022000222222222111111222222222200011000222222222211
1000000000000000000000000000000000110000000000000000011000000000000001
1000000000000000000000000000000000110000000000000000011000000000000001
1000000000000000033333333000000000110000000000000003311330000000000001
1000000000000000000000000000000000000000000000000000011000000000000001
1000000000000000000000000000000000000000000000000000011000000000000001
1000000000000000000000000000000000000000000000000000011000000000000001
1000000000000000011111111000000000000000000000000003322330000000000001
1000000000000000000000000000000000000000000001100000000000000000000001
1000000000000000000000000000003333113333300000000000000000003300000001
1000000000001100000000000000000000110000000000000000000000000000000001
1000000000000000000000000000000000110000000000000000000000000000000001
1000000000000000000000000000003333223333300000000000000000000000000001
1000001110000000000000000000000000000000000000000000000000001133333331
1000001110000000000000000000000000000000000000000000000000001100000001
1000001110000000000000000000000000000000000000000000000000001100000001
1333001110000000000000000010001111111111100000000000000000001133333331
1000001110000000000000000000000000000000000000000000000000000000000001
1000001110000000000001000000000000000000000000000000000000000000000001
1000001110000000000000000000000000000000000000000000000000000000000001
1333002220033311100000000000000000000000000011000000000003331111111111
1000000000000011100000000000000000000000000011000000000000001111111111
10p0000000000011100000000000000000000000000011000000000000001111111111
1000000000000011100000000000000000000000000011000000000000001111111111
1111111111111111111111111111111111111111111111111111111111111111111111