1111111111111111111111111111111111111111111111111111111111111111111111
1000000000000000000000000000000000110000000000000000000000000000000001
1000000000000000000000000000000000110000000000000000000000000000000001
1000000000000000000000000000000000110000000000000000000000000000000001
1000000000000000000000000000000000110000000000000000000000000000000001
1000000000000000000000000000000000110000000000000000000000000000000001
1000000000000000000000000000000000110000000000000000000000000000000001
1000000000000000000000000000000000110000000000000000000000000000000001
1000000000000000000000000000000000110000000000000000000000000000000001
1000000000000000000000000000000000113333300001100000011000003300000001
1000000000000000000000000000000000110000000000000000000000000000000001
1000000000000000000000000000000000110000000000000000000000000000000001
1333000011000001100000000110000000223333300000000000000000000000000001
1000000000000000000000000000000000000000000000000000000000003333333111
1000000000000000000000000000000000000000000000000000000000000000000111
100000000000000000000000000000000p000000000000000000000000000000000111
1333000000000000000333300000001111111113311000000000000000003333333111
1000000000000000000000000000000000000110011000000000000000000000000111
1000000000000000000000000000000000000110011000000000000000000000000111
1000000000000000000000000000000000000110011000000000000000111111111111
1333000000000001100000000110000000000223322000001100000000111111111111
1000000000000001100000000110000000000000000000001100000000111111111111
1000000011000111100011000111100000000000000000001100011000111111111111
1000000011000111100011000111100000000000000000001100011000111111111111
1111111111111111111111111111111111111111111111111111111111111111111111