11111111111111111111111111111111111111111111111111
10000000000000000000000000000000000000000000000001
10000000000000000000000000000000000000000000000001
10000000000000000000000000000000000000000000000001
10000000000000000000000000000000000000000000000001
10000000000000000000001111110000000000000000000001
10000000000000000000000111100000000000000000000001
10000000000000000000000011000000000000000000000001
10000000100010000100000011000001000000000000000001
10000000000000000000000011000001000000000000000001
11000000000000000000000011000000000000000000000001
10000000000000000000000011000000001000000000000001
10000000000000000000000011000000001000000000000001
10000000000000000000000011000000001000000000000001
10000010000000000000000011000000001000001000000001
10000010000000000000000011000000001000001000000001
10000011111110000001111111000000001111111111100001
10000011111110000000111111000000001111111111100001
10000000000000000000000000000000000000000000000001
10000000000001100000000000000000000000000000020011
10000000000000000000000000000000000000000000000001
10000000000000000000000000000000000000000000000001
10000000000000001100000000000000000000000000000001
10000000000000000000000000000000000000000000010001
10000000000000000000111111111110000000000000000001
10000000000000000000000000000000000000000100000001
10000000000000000000000000000000000000000000000001
10000000000000000000000000000000000011000000000001
10000000000000000000000000000000000011000000000001
10000000011000000000000000000000000011000000000001
10000000011000000000000000000000000011000000000001
10000001111000011000000000000000111111111111111111
10000001111000011000000000000000111111111111111111
11111111111111111111111111111111111111111111111111