t1111111111111111111111111111111111
l0000000000000000000000000000000001
10000000000000000000000000000000001
10000000000000000000000000000000001
10000000000000000000000000000000001
10000000000000000000000000000000001
10000000000000000000000000000000001
10000000000000000000000000000000001
10000000000000000000000000000011111
10000000000000000000000000000001001
10000000000000000000000000000000101
10000000000000000000000000000000101
10000000000000000000000000110000011
10000000000000000000000000110000011
10000000000000000000000000110000001
10000000000000000000011000110000001
10000000000000000000011000110000001
10000000000000000000011000110000001
10000000000000000000011000110000001
10000000000000011000011000110000001
10000000000000000000000000000000001
10000000000000000000000000000000001
10000000000000000000000000000000001
10000000000110000000000000000000001
10000000000000000000000000000000001
10000000000000000000000000000000001
10000000000000000000000000000000001
10000001100000000000000000000000001
10000001100000000000000000000000001
10000001100000000000000000000000001
10000001100110001100000000000000001
10000000000110001100000000000000001
10000000000110001100000110000000001
1000000000000000000000000000000p001
10000000000000000000000000000000001
10000000000000000000000000000011111
10000000000000000000000000000011111
10000000000000000000000000000000001
10000000000000000000000001100000001
10000000000000000000000001100000001
10000000000000000000000001100000001
10000000000000000000110001100000001
10000000000000000000110001100000001
10000000000000000000110001100000001
10000000000000000000110001100000001
10000000000000011000000000000000001
10000000000000011000000000000000001
10000000110001111000000000000000001
1000000011000111100000000000000000r
1111111111111111111111111111111111b